1111111111111111111
111111P111100111111
1C00100C10000C00111
1000C00000C0000C011
111000001100E000111
1111111111111111111